                                                                                
                                                                                
                                                                                
                                                                                
                                                                                
                                                                                
                                                                                
                                                                                
                                                                                
                                                                                
                                                                                
                                                                                
                                                                                
                                                                                
                                                                                
                                                                                
                                                                                
                                                                                
                                                                                
                    ############### ### ########### #######                     
                   #...............#...#...........#.......#                    
                   #.#.###########.###.#.#.#########.#.####                     
                   #.#.....#...#.#.....#.#...........#.....#                    
                    ######.#.#.#.#####.#.#################.#                    
                   #.......#.#...#.....#.#.....#.........#.#                    
                   #.#######.#####.#####.###.#.#.#######.#.#                    
                   #.#.....#.......#...#.#...#.#.....#.#.#.#                    
                   #.#.###.#########.#.#.#.###.#####.#.#.#.#                    
                   #...#.#.#...#.....#...#.#...#.....#...#.#                    
                   #.###.#.#.#.#.#########.#####.#####.###.#                    
                   #.....#...#.........#...#...#.....#.#...#                    
                    ####.#### ########.#.###.#.#.###.#.###.#                    
                   #.........#.....#...#.#...#.#...#.#.#...#                    
                   #.#########.###.#.###.#.###.#####.#.#.#.#                    
                   #.#.......#.#.#.#.....#...#.......#...#.#                    
                    ##.#####.#.#.#.#######.#.######## ####.#                    
                   #...#...#.#...#.......#.#.........#...#.#                    
                   #.#####.#.###.#######.#####.#####.#.###.#                    
                   #.#...#.#.....#.....#.#...#...#.#.#.....#                    
                   #.#.#.#.#######.###.#.#.#.###.#.#.######                     
                   #.#.#.....#.#...#.#.#s#.#.#.....#.#.....#                    
                   #.#.#####.#.#.###.#.###.#.#####.#.#.###.#                    
                   #.#.#.....#.......#.....#.....#.#...#...#                    
                   #.#.#.#################.#####.#.#####.#.#                    
                   #...#...#.............#.#.....#.#...#.#.#                    
                    ### ##.#.#.#########.#.#.#######.#.#.#.#                    
                   #...#...#.#.#.....#.#...#...#.....#...#.#                    
                   #.###.#####.#.###.#.#######.###.#.#####.#                    
                   #...#.#.....#.#...#...#.....#...#.#...#.#                    
                    ##.#.#.#####.#.#####.#.#####.#####.#.##                     
                   #...#.#.#.....#.#.....#.....#.......#...#                    
                   #.###.#.#.#####.#.###.#####.#.#########.#                    
                   #...#...#.#.....#.#...#.....#.#...#.....#                    
                    ##.#####.#####.#.#.###.#####.###.#.###.#                    
                   #...#.....#...#...#...#.#.........#.#...#                    
                   #.###.###.#.#.#### ##.#.#.#########.#.##                     
                   #.....#$#.#.#.....#...#.#...#.....#.#.#.#                    
                   #.#####.#.#.#####.#####.#####.###.#.#.#.#                    
                   #.......#.......#.............#.....#...#                    
                    ####### ####### ############# ##### ###                     
                                                                                
                                                                                
                                                                                
                                                                                
                                                                                
                                                                                
                                                                                
                                                                                
                                                                                
                                                                                
                                                                                
                                                                                
                                                                                
                                                                                
                                                                                
                                                                                
                                                                                
                                                                                
                                                                                
                                                                                
